"a" = (/turf/space,/area)
"b" = (/obj/item/stack/rods,/turf/space,/area)
"c" = (/obj/effect/landmark/corpse/officer,/obj/effect/decal/cleanable/blood,/turf/space,/area)
"d" = (/obj/effect/decal/cleanable/blood,/turf/space,/area)
"e" = (/obj/item/weapon/shard,/turf/space,/area)
"f" = (/obj/item/weapon/shard,/obj/effect/decal/cleanable/blood,/turf/space,/area)
"g" = (/obj/structure/lattice,/turf/space,/area)
"h" = (/turf/simulated/wall,/area)
"i" = (/obj/item/weapon/shard,/turf/simulated/floor/plating/airless{broken = 1},/area)
"j" = (/obj/item/stack/sheet/metal,/turf/space,/area)
"k" = (/obj/item/weapon/shard,/obj/item/stack/rods,/turf/space,/area)
"l" = (/obj/item/stack/sheet/metal,/turf/simulated/floor/plating/airless{broken = 1},/area)
"m" = (/obj/item/weapon/shard,/obj/item/stack/rods,/turf/simulated/floor/plating/airless{broken = 1},/area)
"n" = (/obj/effect/decal/cleanable/blood,/turf/simulated/floor/plating/airless{broken = 1},/area)
"o" = (/obj/item/weapon/cable_coil{amount = 2},/obj/effect/decal/cleanable/blood,/turf/simulated/floor/plating/airless{broken = 1},/area)
"p" = (/obj/item/weapon/stock_parts/console_screen,/turf/space,/area)
"q" = (/obj/structure/girder,/turf/simulated/floor/plating/airless,/area)
"r" = (/obj/item/weapon/cable_coil{amount = 2},/obj/effect/decal/cleanable/blood,/turf/space,/area)
"s" = (/turf/simulated/floor/plating/airless{broken = 1},/area)
"t" = (/obj/effect/landmark/corpse/officer,/turf/simulated/floor/plating/airless{broken = 1},/area)
"u" = (/obj/machinery/door/airlock/hatch,/turf/simulated/floor/plating/airless{broken = 1},/area)
"v" = (/obj/structure/shuttle/engine/propulsion/burst{dir = 4},/turf/simulated/floor/plating/airless,/area)
"w" = (/obj/machinery/door/airlock/hatch,/turf/simulated/floor/airless,/area)
"x" = (/obj/structure/girder,/turf/simulated/floor/plating/airless{broken = 1},/area)
"y" = (/obj/item/apc_frame,/turf/simulated/floor/airless,/area)
"z" = (/obj/structure/table,/turf/simulated/floor/airless,/area)
"A" = (/obj/structure/grille,/obj/structure/window/reinforced{dir = 1},/obj/structure/window/reinforced{dir = 8},/obj/structure/window/reinforced{dir = 4},/turf/simulated/floor/plating/airless,/area)
"B" = (/obj/structure/shuttle/engine/heater{dir = 8},/turf/simulated/floor/plating/airless,/area)
"C" = (/turf/simulated/floor/airless,/area)
"D" = (/obj/effect/decal/cleanable/blood,/turf/simulated/floor/airless,/area)
"E" = (/obj/effect/landmark/corpse/bridgeofficer,/obj/structure/stool/bed/chair/office/dark{dir = 4},/turf/simulated/floor/airless,/area)
"F" = (/obj/structure/computerframe,/turf/simulated/floor/airless,/area)
"G" = (/obj/structure/grille,/obj/structure/window/reinforced{dir = 8},/obj/structure/window/reinforced{dir = 4},/turf/simulated/floor/plating/airless,/area)
"H" = (/obj/structure/grille,/obj/structure/window/reinforced,/obj/structure/window/reinforced{dir = 8},/obj/structure/window/reinforced{dir = 4},/turf/simulated/floor/plating/airless,/area)
"I" = (/obj/machinery/light/small,/turf/simulated/floor/airless,/area)
"J" = (/obj/effect/landmark/corpse/officer,/turf/simulated/floor/airless,/area)
"K" = (/obj/structure/stool/bed/chair/office/dark{dir = 4},/turf/simulated/floor/airless,/area)
"L" = (/obj/machinery/door/airlock/hatch,/turf/simulated/floor/plating/airless,/area)
"M" = (/turf/simulated/floor/plating/airless,/area)
"N" = (/obj/machinery/light/small{dir = 1},/turf/simulated/floor/plating/airless,/area)
"O" = (/obj/mecha/combat/durand/durret{dir_in = 2},/turf/simulated/floor/plating/airless,/area)
"P" = (/obj/structure/grille,/obj/structure/window/reinforced,/obj/structure/window/reinforced{dir = 1},/obj/structure/window/reinforced{dir = 8},/turf/simulated/floor/plating/airless,/area)
"Q" = (/obj/structure/grille,/obj/structure/window/reinforced,/obj/structure/window/reinforced{dir = 1},/turf/simulated/floor/plating/airless,/area)
"R" = (/obj/structure/grille,/obj/structure/window/reinforced,/obj/structure/window/reinforced{dir = 1},/obj/structure/window/reinforced{dir = 4},/turf/simulated/floor/plating/airless,/area)

(1,1,1) = {"
aaaaaaaaaaaaaaaaaaaa
aaaaaaaabbaaaaaaaaaa
aabaaaaaaaaaacaabaaa
aaaaaaaaaaaaadaaaaba
aeaaaaeaaaaedaaaaaaa
eaaaaaeeaeabeaaaaeaa
aaeaecbaaaaaeeaaeeaa
aaaadabbbbaaaaeabaaa
aebbfeebabeebeeebaaa
aeabgeaaebbaababaaaa
ahiiggagejkgeelmhaaa
ahnopgqmgggqmrpehaaa
hhnnstqtgggqssanhuhh
vhhqwhhhqghhhxwhhyzA
vBACCCCCDCCCCCCCwEFG
vBHIDCDDICCJJICCwKFG
vhhhLhhhhLhhhhLhhCzH
hhMNMMhMNMMhMNMMhhhh
ahMOMMhMOMMhMOMMhaaa
ahPQQRhPQQRhPQQRhaaa
"}
